9,18,22,18,22,24,20,10,12,10,12,18,22
13,3,0,2,0,2,0,3,0,3,0,4,9
23,5,2,5,2,7,3,5,1,0,3,6,13
19,1,7,2,0,1,0,4,0,3,5,3,9
9,7,3,0,2,0,1,0,4,7,1,0,13
13,2,0,3,0,4,0,3,6,3,0,2,17
0,6,4,0,3,0,4,0,1,0,4,0,21
0,1,5,3,6,4,5,1,0,2,7,4,9
0,0,4,0,4,0,3,0,4,0,2,0,13
10,14,18,22,0,0,0,16,14,24,20,16,14
