16,14,24,20,23,0,1,0,15,10,14,10,12
9,9,16,12,19,2,6,4,13,9,24,20,23
13,11,24,20,9,0,1,5,9,11,24,20,19
15,17,15,9,13,3,7,4,13,18,22,23,23
11,21,13,13,15,0,1,0,9,10,14,19,19
23,10,14,23,13,2,0,3,11,10,12,15,15
19,24,20,19,17,6,4,0,23,10,14,13,13
17,15,17,9,21,1,5,4,19,17,23,9,9
21,13,21,13,23,0,3,7,17,21,19,13,11
10,14,16,14,19,1,0,2,21,16,14,10,12
