9,18,22,24,20,0,0,0,18,22,10,12,17
13,1,0,3,7,3,0,4,0,4,6,4,21
9,5,3,0,3,0,3,0,2,0,4,0,9
13,1,7,1,6,3,0,4,0,2,5,3,13
23,0,3,0,1,0,3,0,2,0,3,0,9
19,1,5,1,7,3,0,4,0,3,6,2,13
23,0,1,0,2,0,4,0,4,0,4,0,0
19,1,7,2,0,3,0,2,0,3,5,3,0
9,0,1,0,2,0,4,0,4,0,2,0,0
13,18,22,10,14,10,14,18,22,24,20,10,14
