16,14,10,14,18,22,24,20,6,1,7,15,9
4,0,1,6,2,5,1,0,1,0,1,13,13
0,3,0,4,0,3,5,1,5,2,0,9,17
2,0,3,7,4,0,3,0,3,7,4,11,21
15,4,0,1,6,3,0,4,9,10,12,16,14
13,5,1,0,1,0,2,7,13,18,22,16,12
23,2,7,4,0,1,6,4,0,2,0,3,15
19,0,4,0,3,0,4,0,2,7,1,0,11
17,3,6,1,7,2,5,3,0,3,0,4,17
21,10,14,10,14,24,20,10,14,0,3,0,21
