18,22,10,14,16,22,18,22,24,20,10,14,9
15,0,1,0,4,0,23,5,4,7,3,6,13
11,1,6,2,0,1,19,3,0,4,0,3,23
23,0,4,5,1,0,3,5,1,5,2,7,19
19,2,5,2,0,1,0,1,6,4,7,3,0
15,0,1,0,4,0,10,14,2,0,3,7,0
11,1,6,1,5,4,23,9,0,1,0,3,0
9,0,3,7,3,5,19,13,3,7,2,5,17
13,2,0,1,7,17,9,24,20,3,0,4,21
16,14,0,0,0,21,13,10,14,24,20,24,20
